,Deaths,Cases,Total Deaths,Date,7 day average
0,0,0,0,02/29/2020,0.0
1,0,0,0,03/01/2020,0.0
2,0,0,0,03/02/2020,0.0
3,0,0,0,03/03/2020,0.0
4,0,1,0,03/04/2020,0.5
5,0,3,0,03/05/2020,0.5
6,0,1,0,03/06/2020,0.7142857142857143
7,0,2,0,03/07/2020,1.0
8,0,5,0,03/08/2020,1.7142857142857142
9,0,16,0,03/09/2020,4.0
10,0,11,0,03/10/2020,5.571428571428571
11,0,31,0,03/11/2020,9.857142857142858
12,0,96,0,03/12/2020,23.142857142857142
13,0,166,0,03/13/2020,46.714285714285715
14,1,163,1,03/14/2020,69.71428571428571
15,0,433,1,03/15/2020,130.85714285714286
16,1,740,2,03/16/2020,234.28571428571428
17,4,783,6,03/17/2020,344.57142857142856
18,6,966,12,03/18/2020,478.14285714285717
19,6,1204,18,03/19/2020,636.4285714285714
20,11,1137,29,03/20/2020,775.1428571428571
21,12,554,41,03/21/2020,831.0
22,10,755,51,03/22/2020,877.0
23,27,910,78,03/23/2020,901.2857142857143
24,23,1212,101,03/24/2020,962.5714285714286
25,37,1254,138,03/25/2020,1003.7142857142857
26,50,1375,188,03/26/2020,1028.142857142857
27,75,1423,263,03/27/2020,1069.0
28,78,864,341,03/28/2020,1113.2857142857142
29,89,1149,430,03/29/2020,1169.5714285714287
30,106,1754,536,03/30/2020,1290.142857142857
31,126,1513,662,03/31/2020,1333.142857142857
32,135,1589,797,04/01/2020,1381.0
33,170,1613,967,04/02/2020,1415.0
34,142,1441,1109,04/03/2020,1417.5714285714287
35,163,922,1272,04/04/2020,1425.857142857143
36,166,1141,1438,04/05/2020,1424.7142857142858
37,169,1462,1607,04/06/2020,1383.0
38,181,1395,1788,04/07/2020,1366.142857142857
39,172,1310,1960,04/08/2020,1326.2857142857142
40,189,1369,2149,04/09/2020,1291.4285714285713
41,178,1153,2327,04/10/2020,1250.2857142857142
42,159,1129,2486,04/11/2020,1279.857142857143
43,201,701,2687,04/12/2020,1217.0
44,158,1065,2845,04/13/2020,1160.2857142857142
45,151,1035,2996,04/14/2020,1108.857142857143
46,132,882,3128,04/15/2020,1047.7142857142858
47,126,884,3254,04/16/2020,978.4285714285714
48,118,959,3372,04/17/2020,950.7142857142857
49,116,575,3488,04/18/2020,871.5714285714286
50,118,635,3606,04/19/2020,862.1428571428571
51,95,983,3701,04/20/2020,850.4285714285714
52,92,896,3793,04/21/2020,830.5714285714286
53,107,854,3900,04/22/2020,826.5714285714286
54,106,786,4006,04/23/2020,812.5714285714286
55,93,629,4099,04/24/2020,765.4285714285714
56,76,405,4175,04/25/2020,741.1428571428571
57,61,332,4236,04/26/2020,697.8571428571429
58,88,608,4324,04/27/2020,644.2857142857143
59,57,711,4381,04/28/2020,617.8571428571429
60,71,681,4452,04/29/2020,593.1428571428571
61,65,600,4517,04/30/2020,566.5714285714286
62,56,497,4573,05/01/2020,547.7142857142857
63,45,263,4618,05/02/2020,527.4285714285714
64,45,247,4663,05/03/2020,515.2857142857143
65,42,462,4705,05/04/2020,494.42857142857144
66,49,433,4754,05/05/2020,454.7142857142857
67,38,450,4792,05/06/2020,421.7142857142857
68,46,403,4838,05/07/2020,393.57142857142856
69,43,344,4881,05/08/2020,371.7142857142857
70,28,119,4909,05/09/2020,351.14285714285717
71,26,188,4935,05/10/2020,342.7142857142857
72,33,410,4968,05/11/2020,335.2857142857143
73,33,400,5001,05/12/2020,330.57142857142856
74,23,362,5024,05/13/2020,318.0
75,14,334,5038,05/14/2020,308.14285714285717
76,27,259,5065,05/15/2020,296.0
77,24,165,5089,05/16/2020,302.57142857142856
78,19,137,5108,05/17/2020,295.2857142857143
79,17,266,5125,05/18/2020,274.7142857142857
80,16,328,5141,05/19/2020,264.42857142857144
81,21,323,5162,05/20/2020,258.85714285714283
82,15,336,5177,05/21/2020,259.14285714285717
83,15,350,5192,05/22/2020,272.14285714285717
84,20,143,5212,05/23/2020,269.0
85,12,162,5224,05/24/2020,272.57142857142856
86,14,160,5238,05/25/2020,257.42857142857144
87,12,319,5250,05/26/2020,256.14285714285717
88,11,246,5261,05/27/2020,245.14285714285714
89,12,221,5273,05/28/2020,228.71428571428572
90,16,167,5289,05/29/2020,202.57142857142858
91,10,105,5299,05/30/2020,197.14285714285714
92,11,84,5310,05/31/2020,186.0
93,10,252,5320,06/01/2020,199.14285714285714
94,6,184,5326,06/02/2020,179.85714285714286
95,13,133,5339,06/03/2020,163.71428571428572
96,10,130,5349,06/04/2020,150.71428571428572
97,6,132,5355,06/05/2020,145.71428571428572
98,10,59,5365,06/06/2020,139.14285714285714
99,6,52,5371,06/07/2020,134.57142857142858
100,13,112,5384,06/08/2020,114.57142857142857
101,6,121,5390,06/09/2020,105.57142857142857
102,11,97,5401,06/10/2020,100.42857142857143
103,4,113,5405,06/11/2020,98.0
104,6,123,5411,06/12/2020,96.71428571428571
105,4,52,5415,06/13/2020,95.71428571428571
106,6,53,5421,06/14/2020,95.85714285714286
107,4,102,5425,06/15/2020,94.42857142857143
108,5,133,5430,06/16/2020,96.14285714285714
109,6,114,5436,06/17/2020,98.57142857142857
110,4,112,5440,06/18/2020,98.42857142857143
111,3,91,5443,06/19/2020,93.85714285714286
112,3,46,5446,06/20/2020,93.0
113,6,54,5452,06/21/2020,93.14285714285714
114,5,110,5457,06/22/2020,94.28571428571429
115,5,95,5462,06/23/2020,88.85714285714286
116,6,101,5468,06/24/2020,87.0
117,4,82,5472,06/25/2020,82.71428571428571
118,3,94,5475,06/26/2020,83.14285714285714
119,7,70,5482,06/27/2020,86.57142857142857
120,1,58,5483,06/28/2020,87.14285714285714
121,3,127,5486,06/29/2020,89.57142857142857
122,2,128,5488,06/30/2020,94.28571428571429
123,3,120,5491,07/01/2020,97.0
124,3,127,5494,07/02/2020,103.42857142857143
125,3,72,5497,07/03/2020,100.28571428571429
126,3,23,5500,07/04/2020,93.57142857142857
127,3,53,5503,07/05/2020,92.85714285714286
128,2,142,5505,07/06/2020,95.0
129,2,123,5507,07/07/2020,94.28571428571429
130,3,121,5510,07/08/2020,94.42857142857143
131,4,104,5514,07/09/2020,91.14285714285714
132,2,90,5516,07/10/2020,93.71428571428571
133,2,73,5518,07/11/2020,100.85714285714286
134,2,55,5520,07/12/2020,101.14285714285714
135,1,123,5521,07/13/2020,98.42857142857143
136,4,111,5525,07/14/2020,96.71428571428571
137,2,149,5527,07/15/2020,100.71428571428571
138,1,91,5528,07/16/2020,98.85714285714286
139,0,105,5528,07/17/2020,101.0
140,4,58,5532,07/18/2020,98.85714285714286
141,3,40,5535,07/19/2020,96.71428571428571
142,3,85,5538,07/20/2020,91.28571428571429
143,3,79,5541,07/21/2020,86.71428571428571
144,1,96,5542,07/22/2020,79.14285714285714
145,4,84,5546,07/23/2020,78.14285714285714
146,2,68,5548,07/24/2020,72.85714285714286
147,2,35,5550,07/25/2020,69.57142857142857
148,4,40,5554,07/26/2020,69.57142857142857
149,1,80,5555,07/27/2020,68.85714285714286
150,1,106,5556,07/28/2020,72.71428571428571
151,1,73,5557,07/29/2020,69.42857142857143
152,2,98,5559,07/30/2020,71.42857142857143
153,1,79,5560,07/31/2020,73.0
154,3,58,5563,08/01/2020,76.28571428571429
155,2,41,5565,08/02/2020,76.42857142857143
156,0,93,5565,08/03/2020,78.28571428571429
157,1,49,5566,08/04/2020,70.14285714285714
158,0,90,5566,08/05/2020,72.57142857142857
159,2,87,5568,08/06/2020,71.0
160,0,90,5568,08/07/2020,72.57142857142857
161,1,58,5569,08/08/2020,72.57142857142857
162,0,48,5569,08/09/2020,73.57142857142857
163,1,74,5570,08/10/2020,70.85714285714286
164,1,82,5571,08/11/2020,75.57142857142857
165,0,114,5571,08/12/2020,79.0
166,2,87,5573,08/13/2020,79.0
167,0,80,5573,08/14/2020,77.57142857142857
168,1,33,5574,08/15/2020,74.0
169,1,49,5575,08/16/2020,74.14285714285714
170,1,96,5576,08/17/2020,77.28571428571429
171,0,66,5576,08/18/2020,75.0
172,1,70,5577,08/19/2020,68.71428571428571
173,3,56,5580,08/20/2020,64.28571428571429
174,0,75,5580,08/21/2020,63.57142857142857
175,2,36,5582,08/22/2020,64.0
176,0,55,5582,08/23/2020,64.85714285714286
177,1,85,5583,08/24/2020,63.285714285714285
178,2,84,5585,08/25/2020,65.85714285714286
179,1,116,5586,08/26/2020,72.42857142857143
180,0,99,5586,08/27/2020,78.57142857142857
181,0,78,5586,08/28/2020,79.0
182,1,38,5587,08/29/2020,79.28571428571429
183,1,60,5588,08/30/2020,80.0
184,0,117,5588,08/31/2020,84.57142857142857
185,0,91,5588,09/01/2020,85.57142857142857
186,2,94,5590,09/02/2020,82.42857142857143
187,2,91,5592,09/03/2020,81.28571428571429
188,1,72,5593,09/04/2020,80.42857142857143
189,3,46,5596,09/05/2020,81.57142857142857
190,2,87,5598,09/06/2020,85.42857142857143
191,0,74,5598,09/07/2020,79.28571428571429
192,1,128,5599,09/08/2020,84.57142857142857
193,0,119,5599,09/09/2020,88.14285714285714
194,1,124,5600,09/10/2020,92.85714285714286
195,2,110,5602,09/11/2020,98.28571428571429
196,0,51,5602,09/12/2020,99.0
197,2,114,5604,09/13/2020,102.85714285714286
198,2,167,5606,09/14/2020,116.14285714285714
199,0,149,5606,09/15/2020,119.14285714285714
200,0,164,5606,09/16/2020,125.57142857142857
201,1,124,5607,09/17/2020,125.57142857142857
202,2,104,5609,09/18/2020,124.71428571428571
203,2,36,5611,09/19/2020,122.57142857142857
204,3,60,5614,09/20/2020,114.85714285714286
205,1,247,5615,09/21/2020,126.28571428571429
206,3,170,5618,09/22/2020,129.28571428571428
207,1,233,5619,09/23/2020,139.14285714285714
208,1,235,5620,09/24/2020,155.0
209,0,186,5620,09/25/2020,166.71428571428572
210,1,108,5621,09/26/2020,177.0
211,2,181,5623,09/27/2020,194.28571428571428
212,1,139,5624,09/28/2020,178.85714285714286
213,2,334,5626,09/29/2020,202.28571428571428
214,4,270,5630,09/30/2020,207.57142857142858
215,1,292,5631,10/01/2020,215.71428571428572
216,1,263,5632,10/02/2020,226.71428571428572
217,1,81,5633,10/03/2020,222.85714285714286
218,3,162,5636,10/04/2020,220.14285714285714
219,0,354,5636,10/05/2020,250.85714285714286
220,2,250,5638,10/06/2020,238.85714285714286
221,1,223,5639,10/07/2020,232.14285714285714
222,3,217,5642,10/08/2020,221.42857142857142
223,0,184,5642,10/09/2020,210.14285714285714
224,0,95,5642,10/10/2020,212.14285714285714
225,2,115,5644,10/11/2020,205.42857142857142
226,1,224,5645,10/12/2020,186.85714285714286
227,3,225,5648,10/13/2020,183.28571428571428
228,3,210,5651,10/14/2020,181.42857142857142
229,2,236,5653,10/15/2020,184.14285714285714
230,3,163,5656,10/16/2020,181.14285714285714
231,3,91,5659,10/17/2020,180.57142857142858
232,1,171,5660,10/18/2020,188.57142857142858
233,6,204,5666,10/19/2020,185.71428571428572
234,2,214,5668,10/20/2020,184.14285714285714
235,3,203,5671,10/21/2020,183.14285714285714
236,2,241,5673,10/22/2020,183.85714285714286
237,0,198,5673,10/23/2020,188.85714285714286
238,0,119,5673,10/24/2020,192.85714285714286
239,3,129,5676,10/25/2020,186.85714285714286
240,2,220,5678,10/26/2020,189.14285714285714
241,3,236,5681,10/27/2020,192.28571428571428
242,3,230,5684,10/28/2020,196.14285714285714
243,2,192,5686,10/29/2020,189.14285714285714
244,4,192,5690,10/30/2020,188.28571428571428
245,2,118,5692,10/31/2020,188.14285714285714
246,9,230,5701,11/01/2020,202.57142857142858
247,7,336,5708,11/02/2020,219.14285714285714
248,6,319,5714,11/03/2020,231.0
249,7,311,5721,11/04/2020,242.57142857142858
250,4,311,5725,11/05/2020,259.57142857142856
251,2,237,5727,11/06/2020,266.0
252,5,222,5732,11/07/2020,280.85714285714283
253,2,224,5734,11/08/2020,280.0
254,1,417,5735,11/09/2020,291.57142857142856
255,2,456,5737,11/10/2020,311.14285714285717
256,2,394,5739,11/11/2020,323.0
257,6,383,5745,11/12/2020,333.2857142857143
258,1,359,5746,11/13/2020,350.7142857142857
259,5,239,5751,11/14/2020,353.14285714285717
260,6,232,5757,11/15/2020,354.2857142857143
261,2,496,5759,11/16/2020,365.57142857142856
262,3,492,5762,11/17/2020,370.7142857142857
263,4,462,5766,11/18/2020,380.42857142857144
264,6,489,5772,11/19/2020,395.57142857142856
265,2,434,5774,11/20/2020,406.2857142857143
266,3,352,5777,11/21/2020,422.42857142857144
267,1,339,5778,11/22/2020,437.7142857142857
268,7,571,5785,11/23/2020,448.42857142857144
269,2,554,5787,11/24/2020,457.2857142857143
270,4,626,5791,11/25/2020,480.7142857142857
271,3,244,5794,11/26/2020,445.7142857142857
272,3,603,5797,11/27/2020,469.85714285714283
273,3,442,5800,11/28/2020,482.7142857142857
274,3,500,5803,11/29/2020,505.7142857142857
275,4,860,5807,11/30/2020,547.0
276,3,881,5810,12/01/2020,593.7142857142857
277,10,803,5820,12/02/2020,619.0
278,4,820,5824,12/03/2020,701.2857142857143
279,6,761,5830,12/04/2020,723.8571428571429
280,6,504,5836,12/05/2020,732.7142857142857
281,4,553,5840,12/06/2020,740.2857142857143
282,7,960,5847,12/07/2020,754.5714285714286
283,8,918,5855,12/08/2020,759.8571428571429
284,9,906,5864,12/09/2020,774.5714285714286
285,2,938,5866,12/10/2020,791.4285714285714
286,8,831,5874,12/11/2020,801.4285714285714
287,9,595,5883,12/12/2020,814.4285714285714
288,5,646,5888,12/13/2020,827.7142857142857
289,6,1107,5894,12/14/2020,848.7142857142857
290,11,1059,5905,12/15/2020,868.8571428571429
291,15,844,5920,12/16/2020,860.0
292,6,644,5926,12/17/2020,818.0
293,13,1023,5939,12/18/2020,845.4285714285714
294,9,765,5948,12/19/2020,869.7142857142857
295,5,767,5953,12/20/2020,887.0
296,7,1305,5960,12/21/2020,915.2857142857143
297,16,1257,5976,12/22/2020,943.5714285714286
298,13,1082,5989,12/23/2020,977.5714285714286
299,9,963,5998,12/24/2020,1023.1428571428571
300,12,340,6010,12/25/2020,925.5714285714286
301,8,1015,6018,12/26/2020,961.2857142857143
302,14,901,6032,12/27/2020,980.4285714285714
303,13,1581,6045,12/28/2020,1019.8571428571429
304,14,1406,6059,12/29/2020,1041.142857142857
305,16,1385,6075,12/30/2020,1084.4285714285713
306,21,929,6096,12/31/2020,1079.5714285714287
307,17,401,6113,01/01/2021,1088.2857142857142
308,17,1086,6130,01/02/2021,1098.4285714285713
309,12,1045,6142,01/03/2021,1119.0
310,24,1868,6166,01/04/2021,1160.0
311,22,1732,6188,01/05/2021,1206.5714285714287
312,19,1569,6207,01/06/2021,1232.857142857143
313,18,1608,6225,01/07/2021,1329.857142857143
314,14,1437,6239,01/08/2021,1477.857142857143
315,22,975,6261,01/09/2021,1462.0
316,16,996,6277,01/10/2021,1455.0
317,12,1720,6289,01/11/2021,1433.857142857143
318,29,1579,6318,01/12/2021,1412.0
319,20,1503,6338,01/13/2021,1402.5714285714287
320,22,1499,6360,01/14/2021,1387.0
321,10,1354,6370,01/15/2021,1375.142857142857
322,20,1040,6390,01/16/2021,1384.4285714285713
323,23,887,6413,01/17/2021,1368.857142857143
324,21,1422,6434,01/18/2021,1326.2857142857142
325,25,1424,6459,01/19/2021,1304.142857142857
326,25,1291,6484,01/20/2021,1273.857142857143
327,19,1350,6503,01/21/2021,1252.5714285714287
328,30,1284,6533,01/22/2021,1242.5714285714287
329,23,875,6556,01/23/2021,1219.0
330,21,859,6577,01/24/2021,1215.0
331,12,1650,6589,01/25/2021,1247.5714285714287
332,22,1312,6611,01/26/2021,1231.5714285714287
333,28,1355,6639,01/27/2021,1240.7142857142858
334,13,1153,6652,01/28/2021,1212.5714285714287
335,14,719,6666,01/29/2021,1131.857142857143
